111111111111111111111111111111111
100000C00000000000010001100000001
1P100100000000010000C000000010001
11100100C00C000011001000010000001
10C100010100000000000000000011001
1010010010000100C10010001110C1001
10C0000010000000000000100100010C1
10000C010010000010C01111001001001
1010010010000100C10010000110C1001
10C0000010000000000000100100010C1
10000C010010000010C01111001001001
1010010010100100C10010000110C1001
10C0000010000000000000100100010C1
10000C010010000010C01111001001001
1010010010000100C10010000110C1001
10C0000010000000000000100100010C1
10000C010010000010C01111001001001
1010010010000100C10010000110C1001
10C0000010000000000000100100010C1
10000C010010000010C01111011001001
10E00000C000000100000000000001001
111111111111111111111111111111111