1111111111111111111111111111111111111111111111
100000C000000000000100011000000011111111111111
1P100100000000010000C0000000100011111111111111
11100100C00C0000110010000100000011111111111111
10C1000101000000000000000000110011111111111111
1010010010000100C10010001110C10011111111111111
10C0000010000000000000100100010C11111111111111
10000C010010000010C011110010010011111111111111
1010010010000100C10010000110C10011111111111111
10C0000010000000000000100100010C11111111111111
10000C010010000010C011110010010011111111111111
1010010010100100C10010000110C10011111111111111
10C0000010000000000000100100010C11111111111111
10000C010010000010C011110010010011111111111111
1010010010000100C10010000110C10011111111111111
10C0000010000000000000100100010C11111111111111
10000C010010000010C011110010010011111111111111
1010010010000100C10010000110C10011111111111111
10C0000010000000000000100100010C11111111111111
10000C010010000010C011110110010011111111111111
10E00000C0000001000000000000010011111111111111
1111111111111111111111111111111111111111111111