11111111111111111111111111111111
10000000000000000000000000C00001
10000000000000000000000000C00001
10000000000000000000000000C00001
10000110000000000000000000C11111
10000000000000000000000000C00001
10000110000000000000000000CCCCC1
10000000000000000000000000C00001
10000000000000000000000000100001
10000000000000000CCCCC0000100001
10000000000P00000CCCC01111100001
10000000000000000CCEC01000100001
10000000000000000CCCC01000100001
11111111111111111111111111111111