1111111111
1P11111111
1000000001
1000000011
1E11111111
100000CC11
1111111111