111111111111111111111111111
100000000000000000000000001
1000000000000000000T0000001
100000001111110000000000001
1000000010T0010000000000001
100000T0111111C0000T0000001
1000000000C0000000000000001
10000000000T000000C00000001
1000000000TTT00000000000001
100001100000000000000000001
10000110000P000000CCC011111
100000000T00000000CEC010001
100000000000000000CCC010001
111111111111111111111111111