111111111111111111111111111
100000000000000000C000000E1
100000110000001111000000001
1000010100C0010000100000001
100010010000100000010000001
100100010000100000010000001
101111111110C00011100000001
10000001000C000100000000001
100000010000001000000000001
100000010000011111110000001
10000000C000000000000000001
100000C00000000000000000001
1P0000000000000000000000001
111111111111111111111111111